111111111111111
1P000E00000UC01
100C0C0C0000011
1101110H0011111
100C0C0C0000011
100C0C0C0000011
111111111111111